290 279 274 270 264 271 277 282 290
285 279 274 268 272 274 279 283 291
285 279 276 276 270 275 277 281 290
285 279 275 275 270 273 279 283 291
280 279 265 265 270 275 280 282 292
275 270 265 262 260 265 272 281 285
285 279 270 264 271 276 280 285 291
285 279 270 268 266 275 279 284 291
285 279 270 266 271 276 279 285 290
