355 355 352 357 351 356 351 357 352
351 351 343 339 282 301 314 339 343
350 350 341 310 305 270 275 310 341
351 351 343 279 271 270 273 279 343
352 352 342 310 265 270 275 280 342
355 355 280 341 314 272 276 279 341
351 351 279 280 276 271 276 280 345
351 351 344 310 305 310 305 310 344
360 310 295 290 315 305 315 326 355
