341 347 352 355 355 352 351 350 345 
282 339 343 365 361 353 396 339 332 
305 310 361 370 373 390 310 276 273 
271 279 343 380 381 388 395 391 273 
305 310 342 382 410 342 275 280 278 
314 279 361 371 375 341 276 279 272 
276 280 345 351 351 345 276 280 276 
305 310 344 337 341 344 305 310 302 
315 326 345 336 330 355 315 326 323 

